***********
******#####
******#.  #
******#.# #
#######.# #
# @ $ $ $ #
# # # # ###
#       #**
#########**
***********
***********