***********
#####******
#   ####***
# # # .#***
#     $###*
### # $  #*
#   #@   #*
# # ######*
#   #******
#####******
***********