***********
*******###*
*#####*#.#*
*#   ###.#*
*#   $ #.#*
*# $  $  #*
*#####@# #*
*****#   #*
*****#####*
***********
***********