*****#####*
*****#   ##
*****#    #
*######   #
##     #. #
# $ $ @  ##
# ######.#*
#        #*
##########*
***********