***********
###########
#....#    #
#  #   $$ #
#  @  ##  #
#     ##$ #
######  $ #
*****#    #
*****######
***********
***********