***********
#####******
#   ####***
# # # .#***
#    $ ###*
### #$.  #*
#   #@   #*
# # ######*
#   #******
#####******
***********