***********
******#####
******#.  #
******#.# #
#######.# #
# # # # ###
#       #**
#########**
***********
***********